5
0   4 0 40 1 2
4   8 0 40 1 2
8  12 0 40 1 2
12 16 0 40 1 2
16 20 0 40 1 2

20
 0  0 32  0  0 1 1  0
32  0 32 32  0 1 1 90
32 32  0 32  0 1 1  0
 0 32  0  0  0 1 1 90
64  0 96  0   0 1 1 90
96  0 96 32   0 1 1  0
96 32 64 32   0 1 1 90
64 32 64  0   0 1 1  0
64 64 96 64   0 1 1 90
96 64 96 96   0 1 1  0
96 96 64 96   0 1 1 90
64 96 64 64   0 1 1  0
 0 64 32 64   0 1 1 90
32 64 32 96   0 1 1  0
32 96  0 96   0 1 1 90
 0 96  0 64   0 1 1  0
256 192 320 192   0 1 1 90
320 192 320 288   0 1 1  0
320 288 256 288   0 1 1 90
256 288 256 192   0 1 1  0

288 48 30 0 0
